####c#####b##
#         C #
#           #
#   ######BA#
#&&&#       #
#1&&# 2  #  a
#############
