#######
##    #
#1   Cb
##BA  #
#  ## #
#  a# ##
# ##   #
c     2#
########
