#####
#1 ##
## ##
# & #
## ##
## 2#
#####
