#######
#1& & #
#& & &#
#&&& &#
#  & 2#
#######
