###########################################################################
#                                                                         #
#                                                                         #
#                                &                                        #
#       1                                                                 #
#                                                                         #
#                                                                         #
#                                                                         #
#                                                                         #
#                                                    2                    #
#                                                                         #
#                                                   &                     #
#                    &                                                    #
#                                                                         #
#                                                                         #
#                                                                         #
#                                                                         #
###########################################################################
