##########
# 1      #
#        #
#    A  a#
#        #
# 2      #
##########
