##########
# 1      #
#    B   #
#    A  a#
#        #
# 2      #
##########
