#########
#1  A  a#
#   B  b#
#   C  c#
#2  D  d#
#########
