#####
#1 ##
## ##
# O #
## ##
## 2#
#####
