#####
#  ##
## ##
# & #
## ##
## 2#
#####
