#####
#  ##
## ##
# O #
## ##
## 2#
#####
