#######
#1O O #
#O O O#
# O O2#
#######
