#######
#1& & #
#& & &#
# & &2#
#######
