#######
#1O O #
#O O O#
#OOO O#
#  O 2#
#######
