######
# 1 ##
#OOO##
#O O #
#O O #
#O O #
#O2  #
######
