######
# 1 ##
#&&&##
#& & #
#& & #
#& & #
#&2  #
######
