######
#2#1##
# & ##
## & #
###&##
### ##
######
