######
#2#1##
# O ##
## O #
###O##
### ##
######
