#######
# ##  #####
#1A    &2B#
# ##  #####
#######
